11111111111111
10010C0C000C01
10C0011111E001
100011E0P0C001
11111111111111