1111111111111111111111
1E0000000000000C000C01
10100101E0000000101001
1010010010101010001001
1P0000000C00C011111111
1111111111111111111111